25 15
51 15
3 6 7 5 3 5 6 2 9 1 2 7 1 9 3 6 1 6 2 6 1 8 7 9 2 1
2 3 7 5 9 2 2 8 9 7 3 6 1 2 9 3 1 9 4 7 8 4 5 1 3 6
1 1 6 3 2 1 6 1 5 5 4 7 6 5 6 9 3 7 4 5 2 5 4 7 4 4
3 1 7 8 6 8 8 4 3 1 4 9 2 1 6 8 9 2 6 6 4 9 5 1 4 8
7 1 7 2 7 2 2 6 1 1 6 1 5 9 4 9 1 9 1 7 7 1 1 5 9 7
7 6 7 3 6 5 6 3 9 4 8 1 2 9 3 9 1 8 8 5 1 9 6 3 8 5
6 1 1 5 9 8 4 8 1 1 3 1 4 4 4 4 7 6 3 1 7 5 9 6 2 1
7 8 5 7 4 1 8 5 9 7 5 3 8 8 3 1 8 9 6 4 3 3 3 8 6 1
4 8 8 8 9 7 7 6 4 3 1 3 1 9 2 5 4 1 5 9 4 6 9 2 2 4
7 7 5 4 8 1 2 8 9 3 6 8 1 2 1 1 5 1 1 1 8 5 1 6 4 6
2 5 8 6 2 8 4 7 2 4 1 6 2 9 9 1 8 1 3 1 1 1 3 4 1 3
9 1 9 6 9 3 3 8 1 5 6 6 4 1 1 4 6 2 6 7 5 6 9 8 7 2
8 2 9 9 6 1 2 7 6 1 3 2 1 5 9 9 1 4 9 1 1 7 5 8 7 1
4 8 1 4 2 9 6 1 1 4 2 2 2 1 5 5 2 9 1 2 8 3 8 1 4 1
9 1 9 6 2 5 4 4 9 9 3 6 1 5 1 2 9 4 3 5 1 7 4 3 1 4
6 9 4 2 2 6 4 1 2 8 8 9 2 8 8 8 6 8 3 8 3 3 3 8 1 4
